#####################
#####################
#####################
#####################
#####.......#########
#####.#####.#########
###......#.....######
#S..####...###.....E#
###......#.....######
######.##############
#####...#############
#####.#.#############
#####.#.#############
#####...#############
######.##############
#####################